Columns: 54
Rows: 30
343434343434343434343434343434343434343434343434343434
565656565656565656565656565656565656565656565656565656
340000000000343434000000000000000000000000000000000034
560000000000565656000000000000000000000000000000000056
340000000000343400000000000000000000000000000000000034
560000000000565600000000000000000000000000000000000056
340000000003434000000000000000000000000000000000000034
560000000005656000000000000000000000000000000000000056
340000000003434000000000000000000000000000000000000034
560000000005656000000000000000000000000000000000000056
340000000034340000000000000000000000000000000000000034
560000000056560000000000000000000000000000000000000056
340000000034340000034000000000000340000000003400000034
560000000056560000056000000000000560000000005600000056
340000343434000000340000000000000034000000343434000034
560000565656000000560000000000000056000000565656000056
340000003400000003400000000000000003400034340000000034
560000005600000005600000000000000005600056560000000056
340000000000000003400000000000000003400034340000000034
560000000000000005600000000000000005600056560000000056
340000000000000000340000000000000034000343400000000034
560000000000000000560000000000000056000565600000000056
340000000000000000034343434343434340000343400000000034
560000000000000000056565656565656560000565600000000056
340000000000000000000000000000000000003434000000000034
560000000000000000000000000000000000005656000000000056
340000000000000000000000000000000000343434000000000034
560000000000000000000000000000000000565656000000000056
343434343434343434343434343434343434343434343434343434
565656565656565656565656565656565656565656565656565656