Columns: 41
Rows: 24
00000000000000000000000000000000000000001
00000000000000000111111111000000000000001
00000000000000000011111111100000000000001
00000000000000000000111111100000000000001
00000034000000000000011111000000000000001
00000056000000000000000000000000000000001
00000034000000343434343400000000000000001
00000056000000565656565600000000000000001
00000000000000340000000000000000000000001
00000000000000560000000000000000000000001
00000000000000340000000000000000000000001
00000000000000560000000000000000000000001
00000034343434340000003400000000000000001
00000056565656560000005600000000000000001
00000000000000000000003400000000000000001
00000000000000000000005600000000000000001
00000000000000000000000000000000000000001
00000000000000000000000000000000000000001
00000000000000000000000000000000000000001
00000000000000000000000000000000000000001
00000000000000000000000000000000000000001
00000000000000000000000000000000000000001
00000000000000000000000000000000000000001
11111111111111111111111111111111111111111